5 5 5 5 5 5 5 5 5 5 5 5 5 5 5 5 5 5 5 5 5 5 5 5 5 5 5 5 5 5 5
5 5 5 5 5 5 5 5 0 0 0 56 0 0 0 0 0 0 0 0 58 0 0 0 0 0 0 5 5 5
5 5 5 5 0 5 0 11 0 0 0 56 0 0 0 0 0 0 0 0 58 0 0 0 0 0 0 0 5 5
5 5 5 5 5 0 0 0 60 0 0 56 0 0 0 0 0 0 0 0 58 0 0 0 0 0 0 0 5
5 5 0 0 0 0 0 0 0 0 0 0 55 53 53 54 50 51 52 53 53 57 0 0 0 5 0 0 0 5
5 0 0 0 0 0 0 0 0 0 0 0 0 0 0 0 0 0 0 0 0 0 0 0 0 0 0 0 0 5
5 0 0 0 11 0 0 0 0 0 0 0 0 0 0 0 0 0 0 0 0 0 0 0 0 0 0 0 0 5
5 0 0 0 0 0 0 0 0 0 0 0 0 5 5 0 0 0 0 0 0 0 0 0 0 0 0 0 0 5
5 0 0 0 0 0 0 0 11 0 0 0 5 5 5 5 0 0 0 0 0 0 0 0 0 0 0 0 0 5
5 0 0 0 11 0 0 0 0 0 0 0 5 5 3 5 5 0 0 0 0 0 0 0 0 0 0 0 0 5
5 0 0 0 0 0 0 0 0 0 0 0 5 5 0 5 5 0 0 0 0 0 0 0 0 0 0 0 0 5
5 0 0 0 0 0 0 0 0 0 0 0 0 5 0 5 0 0 0 0 0 0 0 0 0 0 0 0 0 5
5 0 0 0 0 11 0 0 0 0 0 0 0 0 0 0 0 0 0 0 0 0 0 0 0 0 0 0 0 5
5 0 0 0 0 0 0 0 0 0 0 0 0 0 0 0 0 0 0 0 0 0 0 0 0 0 0 0 0 5
5 0 0 0 0 0 0 0 0 5 0 5 0 0 0 0 0 0 0 0 0 0 0 0 0 0 5 0 0 5
1 1 1 0 0 0 0 0 0 0 0 0 0 0 0 0 0 0 0 0 5 0 0 5 0 5 0 0 5 5
1 1 1 1 1 0 0 0 0 0 0 0 5 0 5 0 0 5 5 5 0 5 5 0 5 0 5 5 5 5
1 1 1 1 1 1 0 0 0 0 0 5 5 5 0 5 5 0 0 0 0 5 5 0 0 5 5 0 5 5
1 1 1 1 1 1 1 0 0 0 0 0 0 5 0 0 0 0 0 5 0 0 0 0 5 5 0 5 5 5
1 1 1 1 1 1 1 1 5 5 5 5 5 5 5 5 5 5 5 5 5 5 5 5 5 5 5 5 5 5
