5 5 5 5 5 5 5 5 5 5 5 5 56 -1 -1 -1 -1 -1 -1 -1 -1 58 5 5 5 5 5 5 5 5 5
5 5 5 5 5 5 5 5 -1 -1 -1 56 -1 -1 -1 -1 -1 -1 -1 -1 58 -1 -1 -1 -1 -1 -1 5 5 5
5 5 5 5 -1 5 -1 -1 -1 -1 -1 56 -1 -1 -1 -1 -1 -1 -1 -1 58 -1 -1 -1 -1 -1 -1 -1 5 5
5 5 5 5 5 -1 -1 -1 60 -1 -1 56 -1 -1 -1 -1 -1 -1 -1 -1 58 -1 -1 -1 -1 -1 -1 -1 5
5 5 -1 -1 -1 -1 -1 -1 -1 -1 -1 -1 55 53 53 54 61 -1 -1 53 53 57 -1 -1 -1 5 -1 -1 -1 5
5 -1 -1 -1 -1 -1 -1 -1 -1 -1 -1 -1 -1 -1 -1 -1 -1 -1 -1 -1 -1 -1 -1 -1 -1 -1 -1 -1 -1 5
5 -1 -1 -1 11 -1 -1 -1 -1 -1 -1 -1 -1 -1 -1 -1 -1 -1 -1 -1 -1 -1 -1 -1 -1 -1 -1 -1 -1 5
5 -1 -1 -1 -1 -1 -1 -1 -1 -1 -1 -1 -1 5 5 -1 -1 -1 -1 -1 -1 -1 -1 -1 -1 -1 -1 -1 -1 5
5 -1 -1 -1 -1 -1 -1 -1 11 -1 5 5 5 5 -1 -1 -1 -1 -1 -1 -1 -1 -1 -1 -1 -1 -1 -1 -1 5
5 -1 -1 -1 11 -1 -1 -1 -1 -1 5 5 3 5 5 -1 -1 -1 -1 -1 -1 -1 -1 -1 -1 -1 -1 -1 -1 5
5 -1 -1 -1 -1 -1 -1 -1 -1 -1 5 5 -1 5 5 -1 -1 -1 -1 -1 -1 -1 -1 -1 -1 -1 -1 -1 -1 5
5 -1 -1 -1 62 -1 -1 -1 -1 -1 -1 -1 -1 5 -1 -1 -1 -1 -1 -1 -1 -1 -1 -1 -1 -1 -1 -1 -1 5
5 -1 -1 -1 -1 -1 -1 -1 -1 -1 -1 -1 -1 -1 -1 -1 -1 -1 -1 -1 -1 -1 -1 -1 -1 -1 -1 -1 -1 5
5 -1 -1 -1 -1 -1 -1 -1 -1 -1 -1 -1 -1 -1 -1 -1 -1 -1 -1 -1 -1 -1 -1 -1 -1 -1 -1 -1 -1 5
5 -1 -1 -1 -1 -1 -1 -1 -1 5 -1 5 -1 -1 -1 -1 -1 -1 -1 -1 -1 -1 -1 -1 -1 -1 5 -1 -1 5
1 1 1 -1 -1 -1 -1 -1 -1 -1 -1 -1 -1 -1 -1 -1 -1 -1 -1 -1 5 -1 -1 5 -1 5 -1 -1 5 5
1 1 1 1 1 -1 -1 -1 -1 -1 -1 -1 5 -1 5 -1 -1 5 5 5 -1 5 5 -1 5 -1 5 5 5 5
1 1 1 1 1 1 -1 -1 -1 -1 -1 5 5 5 -1 5 5 -1 -1 -1 -1 5 5 -1 -1 5 5 -1 5 5
1 1 1 1 1 1 1 -1 -1 -1 -1 -1 -1 5 -1 -1 -1 -1 -1 5 -1 -1 -1 -1 5 5 -1 5 5 5
1 1 1 1 1 1 1 1 5 5 5 5 5 5 5 5 5 5 5 5 5 5 5 5 5 5 5 5 5 5
